########################################
#......................................#
#......................................#
#..######......................######..#
#..######......................######..#
#......................................#
#......................................#
#..............##########..............#
#..................##..................#
#..................##..................#
###................##................###
###........#####........#####........###
###........#................#........###
###........#...####..####...#........###
...........#............................
........................................
###........#...####..####...#........###
###........#................#........###
###........#####........#####........###
###................##................###
#..................##..................#
#..................##..................#
#..............##########..............#
#......................................#
#......................................#
#..######......................######..#
#..######......................######..#
#......................................#
#......................................#
########################################